// Consonants + Consonant Blends

B: b, bl, br

C: c, ch, cl, cr

D: d, dr

F: f, fl, fr

G: g, gh, gl, gn, gr

H: h

J: j

K: k

L: l, ll

M: m

N: n

P: p, ph, pl, pn, pr, ps

Q: q, qu

R: r, rr

S: s, sc, sch, scr, sh, shr, sk, sl, sm, sn, sp, spl, spr, squ, st, str, sw\

T: t, th, thr, tr, tw

V: v, vr

W: w, wh, wr

X: x

Y: y

Z: z

// Letters to check

c: s

h: c, g, p, s, t, w

l: b, c, f, g, l, p, s

m: s

n: g, p, s

p: s

r: b, c, f, g, p, t, w

s: p

t: s

u: q

w: s, t
